1,1,1,1,1,1,1,1,1,0,0,0,0,1,1,1,1,1,1,1,1,1,1,1,1,1,1,0,0,0,0,1,1,1,1,1,1,1,1,1,
1,1,1,1,1,1,1,1,0,0,0,0,0,0,1,1,1,0,0,1,1,0,0,1,1,1,0,0,0,0,0,0,1,1,1,1,1,1,1,1,
1,1,1,1,1,1,1,1,0,0,0,0,0,0,0,0,0,0,0,1,1,0,0,0,0,0,0,0,0,0,0,0,1,1,1,1,1,1,1,1,
1,1,1,1,1,1,1,1,0,0,0,0,0,0,0,0,0,0,0,1,1,0,0,0,0,0,0,0,0,0,0,0,1,1,1,1,1,1,1,1,
1,1,1,1,1,1,1,1,0,0,0,0,0,0,1,1,1,0,0,1,1,0,0,1,1,1,0,0,0,0,0,0,1,1,1,1,1,1,1,1,
1,1,1,1,1,1,2,2,0,0,0,0,0,0,2,2,1,1,1,1,1,1,1,1,2,2,0,0,0,0,0,0,2,2,1,1,1,1,1,1,
1,2,2,2,5,2,2,2,2,1,1,1,1,2,2,2,1,1,1,1,1,1,1,1,2,2,2,1,1,1,1,2,2,2,2,2,2,2,6,1,
1,2,6,2,2,2,1,1,2,2,2,2,2,2,2,2,4,2,6,1,1,6,2,5,2,2,2,2,2,2,2,2,2,2,6,2,2,2,2,1,
1,1,1,1,2,2,2,2,2,1,1,1,1,0,2,2,1,1,1,1,1,1,1,1,2,2,1,2,2,2,2,2,1,2,2,2,2,2,2,1,
1,1,6,5,2,2,1,2,2,0,2,6,1,1,2,2,2,1,1,1,1,1,1,2,2,2,2,2,2,2,2,2,2,2,1,1,6,2,2,1,
1,1,1,1,1,2,2,2,2,0,0,2,2,2,1,2,2,2,1,1,1,1,2,2,2,2,2,1,1,2,0,0,2,2,2,2,2,2,2,1,
1,1,2,2,2,2,2,2,2,0,2,2,2,1,2,2,2,2,2,1,1,2,2,2,2,6,2,2,1,2,0,1,1,1,1,1,2,2,2,1,
1,2,2,2,2,1,2,2,2,2,2,2,1,1,2,2,1,1,2,1,1,2,2,2,2,2,2,2,2,2,0,1,0,0,0,5,2,1,2,1,
1,1,2,2,2,0,2,2,2,2,2,2,1,1,2,2,2,2,1,1,1,1,1,2,2,2,2,2,2,2,0,1,0,0,0,1,2,2,2,1,
1,2,2,1,1,0,2,2,2,2,2,2,2,2,0,1,2,2,4,0,0,0,1,2,2,2,2,2,2,1,0,1,0,0,0,1,2,2,2,1,
1,2,2,2,2,2,2,2,2,2,2,2,2,2,0,0,1,1,1,1,1,0,1,2,2,2,1,2,2,1,0,1,0,0,0,1,2,2,2,1,
1,2,2,2,2,2,2,2,2,2,1,2,2,2,2,2,2,2,1,0,0,0,1,2,2,2,1,2,2,2,0,1,6,6,6,1,2,2,2,1,
1,2,2,2,2,2,2,2,1,1,1,2,2,2,2,2,2,2,1,0,1,1,1,2,2,2,0,1,2,2,0,1,6,6,6,1,2,2,2,1,
1,2,2,2,2,2,2,2,2,6,0,2,2,2,2,2,2,2,1,6,6,7,1,2,2,2,2,2,2,2,2,2,2,2,2,2,2,2,2,1,
1,0,0,0,2,2,2,2,2,2,2,2,2,2,1,2,2,2,1,1,1,1,1,2,2,2,2,2,2,2,1,2,2,2,2,2,2,2,2,1,
1,2,2,1,2,2,2,2,0,2,0,2,2,2,6,2,2,2,2,2,2,1,2,2,2,2,2,2,2,2,2,2,2,2,2,2,2,1,2,1,
1,2,2,2,2,2,2,2,2,2,2,2,2,2,2,2,2,2,2,2,2,1,2,2,2,6,2,2,2,2,2,2,2,2,2,2,2,1,1,1,
1,2,2,2,2,2,2,2,2,2,2,2,2,2,2,2,2,2,2,2,2,1,2,2,2,2,2,2,2,2,2,2,2,2,2,2,2,0,6,1,
1,2,2,2,2,2,2,2,2,2,2,1,1,2,2,2,2,2,2,2,1,2,2,2,2,2,2,2,1,1,1,2,2,2,2,2,2,2,2,1,
1,2,6,2,2,2,2,2,2,2,2,0,6,2,2,2,2,2,2,2,1,2,2,2,2,2,2,2,4,6,4,2,2,2,2,2,2,2,2,1,
1,2,6,6,2,2,2,2,2,2,2,0,2,2,2,2,2,2,2,2,1,2,2,2,2,2,2,2,1,1,1,2,2,2,2,2,2,2,2,1,
1,2,2,2,2,2,1,2,2,2,2,2,2,2,2,1,1,1,1,2,2,1,2,2,2,2,2,2,2,2,2,2,2,2,6,2,2,2,2,1,
1,2,2,2,2,1,1,2,2,2,2,2,2,2,2,5,6,6,5,2,2,1,2,2,1,2,2,2,2,2,2,2,2,2,2,2,2,2,2,1,
1,2,2,2,2,2,2,2,2,2,2,2,2,2,2,1,1,1,1,2,1,2,2,2,1,1,2,2,2,2,2,2,2,2,2,2,2,2,2,1,
1,2,2,2,2,2,2,2,2,2,2,2,2,2,2,2,2,2,2,1,2,2,2,2,2,2,2,2,2,2,2,2,2,2,2,2,2,2,2,1,
1,2,2,2,2,2,2,2,1,2,2,2,2,2,2,2,2,2,2,1,2,2,2,2,2,2,2,2,2,2,2,2,2,2,2,2,2,2,2,1,
1,2,2,2,2,2,2,2,1,1,2,2,6,2,2,2,2,2,2,1,6,6,2,2,2,2,2,2,2,0,2,2,2,2,2,2,2,2,2,1,
1,2,2,2,2,2,2,2,1,1,2,2,6,2,2,2,2,2,2,1,6,6,2,2,2,2,2,2,2,0,1,6,2,2,2,1,2,2,2,1,
1,0,0,0,2,2,2,2,1,1,1,2,2,2,2,2,2,2,2,1,2,2,2,2,2,2,2,2,2,2,2,2,2,2,2,1,2,2,2,1,
1,2,2,1,2,2,2,2,2,2,2,2,2,2,2,2,2,2,2,2,1,2,2,2,2,2,2,2,2,2,2,2,2,2,2,1,2,2,2,1,
1,2,2,2,2,2,2,2,2,2,2,2,2,2,2,2,2,2,2,2,1,2,2,2,2,2,2,2,2,2,2,2,2,2,2,2,2,2,2,1,
1,2,2,2,2,2,2,2,2,2,2,0,0,0,2,2,2,2,2,2,2,2,2,2,2,2,2,2,2,2,2,2,2,2,2,2,2,2,2,1,
1,2,2,2,2,2,2,2,2,2,2,2,6,2,2,2,2,2,2,2,0,1,2,2,2,2,2,2,2,2,2,2,2,2,2,2,2,2,2,1,
1,2,2,2,2,2,2,2,2,2,2,2,2,2,2,1,2,2,2,2,2,1,2,2,2,2,2,2,2,2,2,2,2,2,2,2,2,2,2,1,
1,2,2,6,2,2,2,2,2,2,2,2,2,2,2,1,2,2,2,2,2,1,2,2,2,2,2,2,2,2,2,2,2,2,2,6,2,2,2,1,
1,2,2,6,6,6,2,2,2,2,2,2,2,2,1,1,2,2,2,2,1,2,2,2,2,2,2,2,2,2,1,2,2,2,2,2,2,2,2,1,
1,2,2,2,2,2,2,2,2,2,2,2,2,2,2,2,2,2,2,2,1,2,2,2,2,2,2,2,2,2,2,2,2,2,2,2,2,1,2,1,
1,2,2,2,2,2,2,2,2,2,2,2,2,2,2,2,2,2,2,2,1,2,2,2,2,6,2,2,2,2,2,2,2,2,2,2,2,1,1,1,
1,2,2,2,2,2,2,2,2,2,2,2,2,2,2,2,2,2,2,1,2,2,2,2,2,2,2,2,2,2,2,2,2,2,2,2,2,2,2,1,
1,2,2,1,2,2,2,2,0,2,0,2,2,2,6,2,2,2,2,2,2,1,2,2,2,2,2,2,2,2,2,2,2,2,2,2,2,1,2,1,
1,2,2,2,2,2,2,2,2,2,2,2,2,2,2,2,2,2,2,2,2,1,2,2,2,6,2,2,2,2,2,2,2,2,2,2,2,1,1,1,
1,2,2,2,2,2,2,2,2,2,2,2,2,2,2,2,2,2,2,2,2,1,2,2,2,2,2,2,2,2,2,2,2,2,2,2,2,0,6,1,
1,2,2,2,2,2,2,2,2,2,2,1,1,2,2,2,2,2,2,2,1,2,2,2,2,2,2,2,1,1,1,2,2,2,2,2,2,2,2,1,
1,2,6,2,2,2,2,2,2,2,2,0,6,2,2,2,2,2,2,2,1,2,2,2,2,2,2,2,4,6,4,2,2,2,2,2,2,2,2,1,
1,2,6,6,2,2,2,2,2,2,2,0,2,2,2,2,2,2,2,2,1,2,2,2,2,2,2,2,1,1,1,2,2,2,2,2,2,2,2,1,
1,2,2,2,2,2,1,2,2,2,2,2,2,2,2,1,1,1,1,2,2,1,2,2,2,2,2,2,2,2,2,2,2,2,6,2,2,2,2,1,
1,2,2,2,2,1,1,2,2,2,2,2,2,2,2,5,6,6,5,2,2,1,2,2,1,2,2,2,2,2,2,2,2,2,2,2,2,2,2,1,
1,2,2,2,2,2,2,2,2,2,2,2,2,2,2,1,1,1,1,2,1,2,2,2,1,1,2,2,2,2,2,2,2,2,2,2,2,2,2,1,
1,2,2,2,2,2,2,2,2,2,2,2,2,2,2,2,2,2,2,1,2,2,2,2,2,2,2,2,2,2,2,2,2,2,2,2,2,2,2,1,
1,2,2,2,2,2,2,2,1,2,2,2,2,2,2,2,2,2,2,1,2,2,2,2,2,2,2,2,2,2,2,2,2,2,2,2,2,2,2,1,
1,2,2,2,2,2,2,2,1,1,2,2,6,2,2,2,2,2,2,1,6,6,2,2,2,2,2,2,2,0,2,2,2,2,2,2,2,2,2,1,
1,2,2,2,2,2,2,2,1,1,2,2,6,2,2,2,2,2,2,1,6,6,2,2,2,2,2,2,2,0,1,6,2,2,2,1,2,2,2,1,
1,0,0,0,2,2,2,2,1,1,1,2,2,2,2,2,2,2,2,1,2,2,2,2,2,2,2,2,2,2,2,2,2,2,2,1,2,2,2,1,
1,2,2,1,2,2,2,2,2,2,2,2,2,2,2,2,2,2,2,2,1,2,2,2,2,2,2,2,2,2,2,2,2,2,2,1,2,2,2,1,
1,2,2,2,2,2,2,2,2,2,2,2,2,2,2,2,2,2,2,2,1,2,2,2,2,2,2,2,2,2,2,2,2,2,2,2,2,2,2,1,
1,2,2,2,2,2,2,2,2,2,2,0,0,0,2,2,2,2,2,2,2,2,2,2,2,2,2,2,2,2,2,2,2,2,2,2,2,2,2,1,
1,2,2,2,2,2,2,2,2,2,2,2,6,2,2,2,2,2,2,2,0,1,2,2,2,2,2,2,2,2,2,2,2,2,2,2,2,2,2,1,
1,2,2,2,2,2,2,2,2,2,2,2,2,2,2,1,2,2,2,2,2,1,2,2,2,2,2,2,2,2,2,2,2,2,2,2,2,2,2,1,
1,2,2,6,2,2,2,2,2,2,2,2,2,2,2,1,2,2,2,2,2,1,2,2,2,2,2,2,2,2,2,2,2,2,2,6,2,2,2,1,
1,2,2,6,6,6,2,2,2,2,2,2,2,2,1,1,2,2,2,2,1,2,2,2,2,2,2,2,2,2,1,2,2,2,2,2,2,2,2,1,
1,2,2,2,2,2,2,2,2,2,2,2,2,2,2,2,2,2,2,2,1,2,2,2,2,2,2,2,2,2,2,2,2,2,2,2,2,1,2,1,
1,2,2,2,2,2,2,2,2,2,2,2,2,2,2,2,2,2,2,2,1,2,2,2,2,6,2,2,2,2,2,2,2,2,2,2,2,1,1,1,
1,2,2,2,2,2,2,2,2,2,2,2,2,2,2,2,2,2,2,1,2,2,2,2,2,2,2,2,2,2,2,2,2,2,2,2,2,2,2,1,
1,2,2,1,2,2,2,2,0,2,0,2,2,2,6,2,2,2,2,2,2,1,2,2,2,2,2,2,2,2,2,2,2,2,2,2,2,1,2,1,
1,2,2,2,2,2,2,2,2,2,2,2,2,2,2,2,2,2,2,2,2,1,2,2,2,6,2,2,2,2,2,2,2,2,2,2,2,1,1,1,
1,2,2,2,2,2,2,2,2,2,2,2,2,2,2,2,2,2,2,2,2,1,2,2,2,2,2,2,2,2,2,2,2,2,2,2,2,0,6,1,
1,2,2,2,2,2,2,2,2,2,2,1,1,2,2,2,2,2,2,2,1,2,2,2,2,2,2,2,1,1,1,2,2,2,2,2,2,2,2,1,
1,2,6,2,2,2,2,2,2,2,2,0,6,2,2,2,2,2,2,2,1,2,2,2,2,2,2,2,4,6,4,2,2,2,2,2,2,2,2,1,
1,2,6,6,2,2,2,2,2,2,2,0,2,2,2,2,2,2,2,2,1,2,2,2,2,2,2,2,1,1,1,2,2,2,2,2,2,2,2,1,
1,2,2,2,2,2,1,2,2,2,2,2,2,2,2,1,1,1,1,2,2,1,2,2,2,2,2,2,2,2,2,2,2,2,6,2,2,2,2,1,
1,2,2,2,2,1,1,2,2,2,2,2,2,2,2,5,6,6,5,2,2,1,2,2,1,2,2,2,2,2,2,2,2,2,2,2,2,2,2,1,
1,2,2,2,2,2,2,2,2,2,2,2,2,2,2,1,1,1,1,2,1,2,2,2,1,1,2,2,2,2,2,2,2,2,2,2,2,2,2,1,
1,2,2,2,2,2,2,2,2,2,2,2,2,2,2,2,2,2,2,1,2,2,2,2,2,2,2,2,2,2,2,2,2,2,2,2,2,2,2,1,
1,2,2,2,2,2,2,2,1,2,2,2,2,2,2,2,2,2,2,1,2,2,2,2,2,2,2,2,2,2,2,2,2,2,2,2,2,2,2,1,
1,2,2,2,2,2,2,2,1,1,2,2,6,2,2,2,2,2,2,1,6,6,2,2,2,2,2,2,2,0,2,2,2,2,2,2,2,2,2,1,
1,2,2,2,2,2,2,2,1,1,2,2,6,2,2,2,2,2,2,1,6,6,2,2,2,2,2,2,2,0,1,6,2,2,2,1,2,2,2,1,
1,0,0,0,2,2,2,2,1,1,1,2,2,2,2,2,2,2,2,1,2,2,2,2,2,2,2,2,2,2,2,2,2,2,2,1,2,2,2,1,
1,2,2,1,2,2,2,2,2,2,2,2,2,2,2,2,2,2,2,2,1,2,2,2,2,2,2,2,2,2,2,2,2,2,2,1,2,2,2,1,
1,2,2,2,2,2,2,2,2,2,2,2,2,2,2,2,2,2,2,2,1,2,2,2,2,2,2,2,2,2,2,2,2,2,2,2,2,2,2,1,
1,2,2,2,2,2,2,2,2,2,2,0,0,0,2,2,2,2,2,2,2,2,2,2,2,2,2,2,2,2,2,2,2,2,2,2,2,2,2,1,
1,2,2,2,2,2,2,2,2,2,2,2,6,2,2,2,2,2,2,2,0,1,2,2,2,2,2,2,2,2,2,2,2,2,2,2,2,2,2,1,
1,2,2,2,2,2,2,2,2,2,2,2,2,2,2,1,2,2,2,2,2,1,2,2,2,2,2,2,2,2,2,2,2,2,2,2,2,2,2,1,
1,2,2,6,2,2,2,2,2,2,2,2,2,2,2,1,2,2,2,2,2,1,2,2,2,2,2,2,2,2,2,2,2,2,2,6,2,2,2,1,
1,2,2,6,6,6,2,2,2,2,2,2,2,2,1,1,2,2,2,2,1,2,2,2,2,2,2,2,2,2,1,2,2,2,2,2,2,2,2,1,
1,2,2,2,2,2,2,2,2,2,2,2,2,2,2,2,2,2,2,2,1,2,2,2,2,2,2,2,2,2,2,2,2,2,2,2,2,1,2,1,
1,2,2,2,2,2,2,2,2,2,2,2,2,2,2,2,2,2,2,2,1,2,2,2,2,6,2,2,2,2,2,2,2,2,2,2,2,1,1,1,
1,2,2,2,2,2,2,2,2,2,2,2,2,2,2,2,2,2,2,1,2,2,2,2,2,2,2,2,2,2,2,2,2,2,2,2,2,2,2,1,
1,2,2,1,2,2,2,2,0,2,0,2,2,2,6,2,2,2,2,2,2,1,2,2,2,2,2,2,2,2,2,2,2,2,2,2,2,1,2,1,
1,2,2,2,2,2,2,2,2,2,2,2,2,2,2,2,2,2,2,2,2,1,2,2,2,6,2,2,2,2,2,2,2,2,2,2,2,1,1,1,
1,2,2,2,2,2,2,2,2,2,2,2,2,2,2,2,2,2,2,2,2,1,2,2,2,2,2,2,2,2,2,2,2,2,2,2,2,0,6,1,
1,2,2,2,2,2,2,2,2,2,2,1,1,2,2,2,2,2,2,2,1,2,2,2,2,2,2,2,1,1,1,2,2,2,2,2,2,2,2,1,
1,2,6,2,2,2,2,2,2,2,2,0,6,2,2,2,2,2,2,2,1,2,2,2,2,2,2,2,4,6,4,2,2,2,2,2,2,2,2,1,
1,2,6,6,2,2,2,2,2,2,2,0,2,2,2,2,2,2,2,2,1,2,2,2,2,2,2,2,1,1,1,2,2,2,2,2,2,2,2,1,
1,2,2,2,2,2,1,2,2,2,2,2,2,2,2,1,1,1,1,2,2,1,2,2,2,2,2,2,2,2,2,2,2,2,6,2,2,2,2,1,
1,1,1,1,1,1,1,1,1,1,1,1,1,1,1,1,1,1,1,1,1,1,1,1,1,1,1,1,1,1,1,1,1,1,1,1,1,1,1,1,
