1,1,1,1,1,1,1,1,1,0,0,0,0,1,1,1,1,1,1,1,1,1,1,1,1,1,1,0,0,0,0,1,1,1,1,1,1,1,1,1,
1,1,1,1,1,1,1,1,0,0,0,0,0,0,1,1,1,0,0,1,1,0,0,1,1,1,0,0,0,0,0,0,1,1,1,1,1,1,1,1,
1,1,1,1,1,1,1,1,0,0,0,0,0,0,0,0,0,0,0,1,1,0,0,0,0,0,0,0,0,0,0,0,1,1,1,1,1,1,1,1,
1,1,1,1,1,1,1,1,0,0,0,0,0,0,0,0,0,0,0,1,1,0,0,0,0,0,0,0,0,0,0,0,1,1,1,1,1,1,1,1,
1,1,1,1,1,1,1,1,0,0,0,0,0,0,1,1,1,0,0,1,1,0,0,1,1,1,0,0,0,0,0,0,1,1,1,1,1,1,1,1,
1,1,1,1,1,1,2,2,0,0,0,0,0,0,2,2,1,1,1,1,1,1,1,1,2,2,0,0,0,0,0,0,5,5,1,1,1,1,1,1,
1,2,2,2,6,2,2,2,2,1,1,1,1,2,2,2,1,1,1,1,1,1,1,1,2,0,2,1,1,1,1,2,2,2,2,2,6,6,3,1,
1,2,7,2,2,2,1,1,2,2,2,7,7,2,2,2,2,2,6,1,1,3,2,2,2,0,0,3,3,7,2,2,2,2,3,2,2,2,2,1,
1,1,1,1,2,2,2,2,2,1,1,1,1,0,2,2,1,1,1,1,1,1,1,1,2,2,1,0,2,2,2,2,1,2,2,2,2,2,2,1,
1,1,5,5,2,2,1,2,2,0,2,7,1,1,2,2,2,1,1,1,1,1,1,2,2,2,2,2,0,2,2,2,2,2,1,1,3,3,2,1,
1,1,1,1,1,2,2,2,2,0,0,2,2,3,1,2,2,2,1,1,1,1,2,2,2,2,2,1,1,2,0,0,2,2,2,2,2,2,2,1,
1,1,2,2,2,2,2,2,2,0,2,2,2,1,2,2,2,2,2,1,1,7,2,7,2,6,2,5,1,2,0,1,1,1,1,1,2,2,2,1,
1,2,2,2,2,1,2,2,5,2,2,2,1,1,2,2,1,1,2,1,1,7,2,7,2,2,2,2,5,2,0,1,0,0,0,2,2,1,2,1,
1,1,2,2,2,0,2,2,5,2,2,2,1,1,2,2,2,2,1,1,1,1,1,2,2,2,2,2,2,2,0,1,0,0,0,1,2,2,2,1,
1,6,2,1,1,0,5,2,2,2,2,2,2,7,0,1,2,2,5,0,0,0,1,2,2,2,2,2,2,1,0,1,0,0,0,1,2,2,2,1,
1,6,5,2,2,2,7,2,2,2,2,2,0,2,0,0,1,1,1,1,1,0,1,2,2,2,1,2,2,1,0,1,0,0,0,1,6,2,2,1,
1,6,2,2,2,2,2,2,2,2,1,2,2,2,2,2,2,2,1,0,0,0,1,2,2,5,1,2,2,2,0,1,3,3,3,1,2,2,2,1,
1,2,2,2,2,2,2,2,1,1,1,2,2,2,3,2,2,2,1,0,1,1,1,2,5,2,0,1,2,2,0,1,6,6,6,1,2,2,2,1,
1,2,2,2,2,2,2,2,2,3,0,2,2,2,2,2,2,2,1,3,3,5,1,2,2,2,0,0,0,2,3,5,6,2,2,2,2,2,2,1,
1,0,0,0,2,2,2,2,2,2,2,2,2,2,1,2,2,2,1,1,1,1,1,2,2,2,2,2,2,2,1,2,2,2,2,2,2,2,2,1,
1,2,2,1,2,2,2,2,0,2,0,2,2,2,6,2,2,2,2,2,5,1,2,2,2,2,2,2,2,2,2,2,2,2,2,7,2,1,2,1,
1,2,2,2,2,2,2,2,2,2,2,2,2,2,2,2,2,2,2,2,2,1,2,2,2,6,2,2,2,2,2,2,2,2,7,7,2,1,1,1,
1,2,2,2,2,2,3,2,2,2,2,2,2,2,2,2,2,2,7,2,2,1,2,2,2,2,2,2,2,2,2,2,2,2,2,2,2,0,6,1,
1,3,2,2,2,2,2,2,2,2,2,1,1,2,2,2,2,7,7,2,1,2,2,2,2,2,2,2,1,1,1,2,2,2,2,2,2,2,2,1,
1,3,6,2,2,2,2,2,2,2,2,0,6,5,2,2,2,2,2,2,1,2,2,2,2,2,2,2,5,6,5,2,2,2,3,2,2,2,2,1,
1,2,6,6,2,2,2,2,2,2,2,0,5,5,2,2,2,2,2,2,1,2,2,2,2,2,2,2,1,1,1,2,2,2,2,2,2,2,2,1,
1,2,2,2,2,2,1,2,2,2,2,2,2,2,2,1,1,1,1,2,2,1,2,2,2,2,2,2,2,2,6,2,2,2,6,2,2,2,2,1,
1,2,2,2,2,1,1,2,2,2,2,2,2,2,6,5,3,3,5,2,2,1,2,2,1,2,2,2,2,6,6,2,2,2,2,2,2,2,2,1,
1,2,2,2,2,2,2,2,2,2,2,2,2,2,2,1,1,1,1,2,1,2,2,2,1,1,2,2,2,2,2,2,2,2,2,2,2,2,2,1,
1,2,2,2,2,2,2,2,2,2,2,2,2,2,2,2,6,6,2,1,2,2,2,2,2,2,2,2,2,2,2,2,2,2,2,2,2,2,2,1,
1,2,2,2,2,7,2,2,1,2,2,2,2,2,2,2,2,2,2,1,2,2,2,2,2,7,2,2,2,2,2,2,2,2,2,2,2,2,2,1,
1,2,2,7,7,7,2,2,1,1,2,2,6,2,2,2,2,2,2,1,3,6,2,2,2,7,2,2,2,0,2,2,2,2,2,2,2,2,2,1,
1,2,2,2,2,2,2,2,1,1,2,2,6,2,2,2,2,2,2,1,3,3,2,2,2,7,7,2,2,0,1,6,2,2,2,1,2,2,2,1,
1,0,0,0,2,2,2,2,1,1,1,2,2,2,2,2,2,2,2,1,2,2,2,2,2,2,2,2,2,2,2,2,2,2,2,1,2,2,2,1,
1,2,2,1,2,2,2,2,2,2,2,2,2,2,2,2,7,7,2,2,1,2,2,2,2,2,2,2,2,2,2,2,2,2,2,1,2,2,2,1,
1,2,2,2,2,2,2,2,2,2,2,2,2,2,2,2,2,7,2,2,1,2,2,2,2,2,2,2,2,2,2,2,2,2,2,2,2,2,2,1,
1,2,2,2,2,2,2,2,2,2,2,0,0,0,2,2,2,2,2,2,2,2,2,2,2,2,2,2,7,2,2,2,2,2,2,2,2,2,2,1,
1,2,2,2,2,2,2,2,2,2,2,2,6,2,2,2,2,2,2,2,0,1,2,2,2,2,2,2,2,7,7,2,2,2,2,2,2,2,2,1,
1,2,2,2,2,2,2,2,2,2,2,2,2,2,2,1,2,2,2,2,2,1,2,2,2,2,2,2,2,2,6,2,2,2,2,2,2,2,2,1,
1,2,2,6,2,2,2,2,2,2,2,2,2,2,2,1,2,2,2,2,2,1,2,2,2,2,2,2,2,2,6,2,2,5,2,6,2,2,2,1,
1,2,2,3,3,6,2,2,2,2,2,2,2,2,1,1,2,2,2,2,1,2,2,2,2,2,2,2,2,2,1,2,2,5,2,2,2,2,2,1,
1,2,2,2,2,2,2,2,5,5,5,2,2,2,2,2,2,2,2,2,1,2,2,2,2,2,2,2,2,2,2,2,2,2,2,2,2,1,2,1,
1,2,2,2,2,2,2,2,2,2,2,2,2,2,2,2,2,2,2,2,1,2,2,2,2,3,2,2,2,2,2,2,2,2,2,2,2,1,1,1,
1,2,2,2,2,2,2,2,2,2,2,2,2,2,2,2,2,2,2,1,2,2,2,2,2,2,2,2,2,2,2,2,2,2,2,2,2,2,2,1,
1,2,2,1,2,2,2,2,0,2,0,2,2,2,7,2,3,2,2,2,1,1,2,2,2,2,2,2,2,2,2,6,2,2,2,2,2,1,2,1,
1,2,2,2,2,2,2,2,2,2,2,2,2,2,2,2,3,3,2,2,2,1,2,2,2,7,2,2,2,2,2,2,2,2,5,2,2,1,1,1,
1,2,2,2,2,2,2,2,2,2,2,2,2,2,2,2,2,2,2,2,2,1,2,2,2,2,2,2,2,2,2,2,2,2,5,5,2,0,6,1,
1,2,2,2,2,2,2,2,2,2,2,1,1,2,2,2,2,2,2,2,1,2,2,2,2,2,2,2,1,1,1,2,2,2,2,2,2,2,2,1,
1,2,6,2,2,2,2,2,2,2,2,0,6,2,2,5,2,2,2,2,1,2,2,2,2,2,2,2,3,6,3,2,2,2,2,2,2,2,2,1,
1,2,6,6,2,2,2,2,2,2,2,0,2,2,2,5,2,2,2,2,1,2,2,2,2,2,2,2,1,1,1,2,2,2,2,2,2,2,2,1,
1,2,2,2,2,2,1,5,5,5,2,2,2,2,2,2,2,2,2,2,2,1,2,2,2,2,2,2,2,2,2,2,2,2,6,2,2,2,2,1,
1,2,2,2,2,1,1,2,2,2,2,2,2,2,2,2,2,2,2,2,2,1,2,2,1,2,2,2,2,0,2,2,2,2,2,2,2,2,2,1,
1,2,2,2,2,2,2,2,2,2,2,2,2,2,2,2,2,2,2,2,1,2,2,2,1,1,2,2,2,0,0,2,2,2,2,2,2,2,2,1,
1,2,2,2,2,2,2,2,2,2,2,2,2,2,2,3,2,2,2,1,2,2,2,2,2,2,2,2,2,2,2,2,2,2,2,7,7,7,2,1,
1,2,2,5,5,2,2,2,2,2,2,2,2,2,2,3,3,2,2,1,2,2,2,5,2,2,2,2,2,2,2,2,2,2,2,2,2,2,2,1,
1,2,2,2,2,2,2,2,7,2,2,2,6,2,2,2,2,2,2,1,2,2,2,2,2,2,2,2,2,0,2,2,2,2,2,2,2,2,2,1,
1,2,2,2,2,2,2,7,7,2,2,2,6,2,2,2,2,0,2,1,2,2,2,2,2,5,2,2,2,0,1,6,2,2,2,1,2,2,2,1,
1,0,0,0,2,2,2,2,2,2,2,2,2,2,2,2,2,0,2,1,2,2,2,2,0,5,0,2,2,2,2,2,2,2,2,1,5,5,5,1,
1,2,2,1,2,2,2,2,2,2,2,2,2,2,2,2,2,2,2,2,1,2,2,2,0,5,0,2,2,2,2,2,2,2,2,1,2,2,2,1,
1,2,2,2,2,2,2,2,2,2,2,2,2,2,2,2,2,2,2,2,1,2,2,2,0,0,0,2,2,2,2,2,2,2,2,2,2,2,2,1,
1,2,2,2,2,0,2,2,2,6,2,0,0,0,2,2,2,2,2,2,1,2,2,2,2,0,2,2,2,2,3,2,2,2,2,2,2,2,2,1,
1,2,2,2,0,0,2,2,2,6,2,2,5,2,2,2,2,2,2,2,1,1,2,2,2,2,2,2,2,3,2,2,0,2,2,2,2,2,2,1,
1,2,2,2,2,2,2,2,2,2,2,2,2,2,2,1,2,2,2,2,2,1,2,2,2,2,2,2,2,2,2,2,2,0,2,2,2,2,2,1,
1,2,2,3,2,2,2,2,2,2,2,2,2,2,2,1,2,2,2,2,2,1,2,2,2,2,2,2,2,2,2,2,2,2,2,6,2,2,2,1,
1,2,2,3,3,6,2,5,2,2,2,2,2,2,1,1,2,2,2,2,1,2,2,2,2,5,2,2,2,2,1,2,2,2,2,2,2,2,2,1,
1,2,2,2,2,2,2,2,2,2,2,5,2,2,2,2,2,2,2,2,1,2,2,2,0,2,2,2,2,2,2,2,7,1,2,2,2,1,2,1,
1,2,2,2,2,2,2,2,2,2,2,2,2,2,2,2,7,7,2,2,1,2,2,2,0,6,2,2,2,2,2,2,7,7,2,2,2,1,1,1,
1,2,2,2,2,2,2,2,2,2,2,2,2,2,2,2,2,7,2,1,2,2,2,2,0,0,2,2,2,1,2,2,7,7,2,2,2,2,2,1,
1,2,2,1,2,2,7,2,0,2,0,2,2,5,6,2,2,2,2,2,2,1,2,2,2,2,2,2,2,2,2,2,2,2,2,2,2,1,2,1,
1,2,2,2,2,7,7,2,2,2,2,2,2,2,2,2,2,2,2,2,2,1,2,2,2,6,2,2,2,2,2,2,2,2,2,2,2,1,1,1,
1,2,2,2,2,2,2,2,2,2,2,2,2,2,2,2,6,2,2,2,2,1,2,2,2,2,2,2,2,2,2,2,2,5,2,2,2,0,5,1,
1,2,2,2,2,2,2,2,2,2,2,1,1,2,2,6,6,2,2,2,1,2,2,2,2,2,2,2,1,1,1,2,2,2,2,2,2,2,2,1,
1,2,5,2,2,2,2,2,2,2,2,0,6,2,2,2,2,2,2,2,1,2,2,2,2,2,2,2,1,3,2,2,2,2,2,2,2,2,2,1,
1,2,5,5,2,2,2,2,2,2,2,0,2,2,2,2,2,2,5,2,1,2,2,2,2,2,2,2,6,1,1,2,2,2,2,2,2,2,2,1,
1,2,2,2,2,2,1,2,2,2,2,2,2,2,2,2,2,2,2,2,2,1,2,2,2,2,2,2,2,2,2,2,2,2,5,2,2,2,2,1,
1,2,2,2,2,1,1,2,2,2,2,2,2,2,2,2,2,2,2,2,2,1,2,2,1,2,2,2,2,2,2,2,2,2,2,2,2,2,2,1,
1,2,2,2,2,2,2,2,2,2,1,1,1,2,2,2,2,2,2,2,1,2,2,2,1,1,2,2,2,2,6,6,2,3,2,2,2,6,2,1,
1,2,2,2,2,2,2,2,2,2,1,5,1,2,2,2,2,2,2,1,2,2,2,2,2,2,2,2,2,2,2,6,2,2,2,2,2,2,2,1,
1,2,2,2,2,2,2,7,2,2,2,6,2,2,2,1,2,2,2,1,2,2,2,2,2,2,2,2,2,2,2,2,2,2,2,2,2,2,2,1,
1,2,2,2,2,3,2,2,2,2,2,0,2,2,2,3,2,2,2,1,3,3,2,2,2,2,2,2,2,0,2,2,2,2,2,2,2,2,2,1,
1,2,2,2,2,2,2,2,2,2,2,2,2,0,6,3,2,2,2,1,6,6,2,2,2,2,2,2,2,0,1,1,2,2,2,1,2,2,2,1,
1,0,0,0,2,2,2,2,2,2,2,2,2,0,0,0,2,2,2,1,2,2,2,2,2,2,2,2,2,2,2,2,2,2,2,1,2,2,2,1,
1,2,2,1,2,2,2,2,2,2,2,2,2,2,2,2,2,2,2,2,1,2,2,2,2,2,3,0,2,2,2,2,2,2,2,1,2,2,2,1,
1,2,2,2,2,2,2,2,2,2,2,2,2,2,2,2,2,2,2,2,1,2,2,2,2,2,3,0,2,2,3,2,2,2,2,2,2,2,2,1,
1,2,2,2,3,2,2,2,2,2,2,0,0,0,2,2,2,2,2,2,2,2,2,2,2,2,0,0,2,2,3,3,3,2,2,2,3,2,2,1,
1,2,2,2,2,2,2,2,2,2,2,2,6,2,2,2,2,2,2,2,0,1,2,2,2,2,2,2,2,2,0,0,1,2,2,2,2,2,2,1,
1,2,2,2,2,2,2,2,2,7,2,2,2,2,2,1,2,2,2,2,2,1,2,2,2,2,2,2,2,2,2,2,2,2,2,2,2,2,2,1,
1,2,2,6,2,2,2,2,2,2,6,2,2,2,2,1,2,2,2,2,2,1,2,2,2,2,2,2,2,2,2,2,2,2,2,6,2,2,2,1,
1,2,2,5,5,6,2,2,2,2,6,2,2,2,1,1,2,2,2,2,1,2,2,2,2,2,2,2,2,2,1,2,2,2,2,2,2,2,2,1,
1,2,2,2,2,2,2,2,2,2,2,2,2,2,2,2,2,2,2,2,1,2,2,2,1,1,1,2,2,2,2,2,2,2,2,2,2,1,2,1,
1,2,2,2,2,2,2,2,2,2,2,2,2,2,2,2,3,2,2,2,1,2,2,2,1,3,1,2,2,2,2,2,2,2,0,2,2,1,1,1,
1,2,2,2,2,2,2,2,2,2,2,2,2,2,2,2,3,2,2,1,2,2,2,2,2,0,0,2,2,2,2,2,3,2,0,2,2,2,2,1,
1,2,2,1,2,7,2,2,0,2,0,2,2,2,6,2,3,2,2,2,2,1,2,2,1,1,1,2,2,2,2,2,2,2,0,2,2,1,2,1,
1,2,2,2,2,7,7,2,2,2,2,2,2,2,2,2,2,2,2,2,2,1,2,2,1,6,1,2,2,2,2,2,2,2,2,2,2,1,1,1,
1,2,2,2,2,2,2,2,2,2,2,2,2,2,2,2,2,7,2,2,2,1,2,2,2,0,0,2,2,3,2,2,2,2,2,2,2,0,6,1,
1,2,2,2,2,2,2,2,2,2,2,1,1,2,2,2,7,7,2,2,1,2,2,2,2,2,2,2,2,2,2,2,2,2,2,2,2,2,2,1,
1,2,6,2,2,2,2,2,2,2,2,0,5,2,2,2,2,2,2,2,1,2,2,2,2,2,2,2,0,2,2,2,0,1,2,2,2,2,2,1,
1,2,6,6,2,2,2,2,2,2,2,0,2,2,2,2,2,2,2,2,1,2,2,2,2,2,2,2,2,2,2,2,2,2,2,2,2,2,2,1,
1,2,2,2,2,2,1,2,2,2,2,2,2,2,2,1,1,1,1,2,2,1,2,2,2,2,2,2,2,2,2,2,2,2,6,2,2,2,2,1,
1,1,1,1,1,1,1,1,1,1,1,1,1,1,1,1,1,1,1,1,1,1,1,1,1,1,1,1,1,1,1,1,1,1,1,1,1,1,1,1,
